-23
35
-10
14
00000000000000000000000000000000000000000000000000000000000
11111111111111111111111111111111111111111111111110000000000
10000000000000000000000000000000000000000000000010000000000
10000000000000000000000000000000000000000000000010000000000
10000000000000000000000000000000000000000000000010000000000
10000000000000000000000000000000000000000000000010000000000
10000001111111111111111111111111111111111100000010000000000
10000001000000000000000000000000000000000100000010000000000
10000001000000000000000000000000000000000100000010000000000
10000001000000000000000000000000000000000100000010000000000
10000001000000000000000000000000000000000100000010000000000
10000001000000000000000000000000000000000100000010000000000
10000001000000000000000000000000000000000100000010000000000
10000001000000000000000000000000000000000100000010000000000
10000001000000000000000000000000000000000100000010000000000
10000001000000000000000000000000000000000100000010000000000
10000001000000000000000000000000000000000100000010000000000
10000001000000000000000000000000000000000100000010000000000
10000001000000000000000000000000000000000100000010000000000
10000001000000000000000000000000000000000100000010000000000
10000001000000000000000000000000000000000100000010000000000
10000001111111111111111111111111111111111100000010000000000
10000000000000000000000000000000000000000000000010000000000
10000000000000000000000000000000000000000000000010000000000
10000000000000000000000000000000000000000000000010000000000
