-23
31
-10
14
1111111111111111111111111111111111111111111111111111111
0000000000000000000000000000000000000000000000000000001
0000000000000000000000000000000000000000000000000000001
0000000000000000000000000000000000000010000000000000001
0000011000000000000000000000000000000000000000000000001
0000000000000000000000000000000000000000011000000000001
0000000000000001111111111111111111100000000000001000001
0000000000000001000000000000000000100000000000000000001
0000000000000001000000000000000000100000000000000000001
0000000000000001000000000000000000100000000000000000001
0000000010000001000000000000000000100000000000000000001
0000000000000001000000000000000000100000000000000000001
0000000000000001000000000000000000100000000000011000001
0000000000000001000000000000000000100000000000000000001
0000000000000001000000000000000000100000000000000000001
0000000000000001000000000000000000100000000000000000001
0000000000000001111111110001111111100000000000000000001
0000000000000000000000000000000000000000000000000000001
0000000000000000000000000000000000000000000000000000001
0000000000000000000000000000000000000000001000000000001
0000000000000000000000000000000000000000000000000000001
0000000000000000000000000000000000000000000000000000001
0000000000000000000000000000000000000000000000000000001
0000000000000000000000000000000000000000000000000000001
1111111111111111111111111111111111111111111111111111111
